111111111111111111111111111111111111111111111111111111111111111111111111111111111111
1E0000000000000C00000C0000C0000C0000C0000C0000C0000C0000C0000C0000C0000C0000000000P1
101001010010000010100100001000010000100001000010000100001000010000100001000000010101
101001001010101000100100001000010000100001000010000100001000010000100001000000010101
100000000C00C000000000000000000000000000000000000000000000000000000000000000001001C1
111111111111111111111111111111111111111111111111111111111111111111111111111111111111
