1111111111
1P000000E1
1000000001
1000000001
100000C001
1000000001
1000000001
1000000001
1000100001
1000100001
1000100001
1000100001
1000100001
1000100001
1000100001
1000100001
1000100001
1000100001
1000100001
1000100001
1000100001
1000100001
1000100001
1000100001
1000100001
1000100001
1000100001
1000100001
1000000001
1000000001
100CC00001
1000000001
1000000001
1000C00001
1000000001
1000000001
1C00000001
1000000001
1000000001
100000C001
1111111111
