1111111111
100P0EC001
1000100011
1111111111