111111111
10RC0R001
1RRR0R001
1EP001001
111111111


