111111111111111
100000010P01001
100000010011001
1000000001110E1
1000000000000C1
100000000000001
111111111111111
