1111111111
1P0000C001
1111111101
1C0C000001
1E1111R111
1111111111