1111111111111
10000000000C1
1000010111001
1P0011ER00001
1111111111111
