111111111111111111111111111111111111111111111111111111111111111111111111111111111111
1E01000R0000000C00000C0000C0000C0000C0000C0000C0000C0000C0000C0000C0000CR00000000001
1010010100100000101001000010000100001000010000100001000010000100R0100001000000010101
1010010010101010001001000010000100001000010000100001000010000100001000010000000011P1
100000000C00C000000000000000000000000000000000000000000000000000000000000000001R11C1
111111111111111111111111111111111111111111111111111111111111111111111111111111111111
