1111111111
10000000E1
1000000001
1000000001
1000000001
1000000001
1000000001
1000000001
1000100001
1000100001
1000100001
1000100001
1000100001
1000100001
1000100001
1000100001
1000100001
1000100001
1000100001
1000100001
1000100001
1000100001
1000100001
1000100001
1000100001
1000100001
1000100001
10001000P1
1000000001
1000000001
1000R00001
1000000001
1000000001
1000000001
1000000001
10000000R1
1C00000001
100R000001
1000000001
100000C001
1111111111
