111111111111111
1R0000001P0ER11
100000011111C01
100000000111001
100000000000001
100000000000001
111111111111111
111111111111111
111111111111111
111111111111111
