11111111111
1R00000C001
10000000001
100E0001001
11000P0C001
11111111111

